NO textures/paint.xpm
SO textures/mossy.xpm
WE textures/eagle.xpm
EA textures/paint2.xpm

F 101,183,65
C 0,0,0

1111111111
1111111111
11111111111
1E1
111111
