NO textures/path
SO textures/mossy.xpm
WE textures/eagle.xpm
EA textures/paint2.xpm


F 101,183,65
C 0,0,0

1111111111
1000000001
1000000001
100000E001
1001000001
1001110101
10000101011
1000010101
1000000001
1111111111
